Museu do Traje|Foi criado com o intuito de estudar e divulgar a identidade e patrimonio etnografico vianense (o traje a vianesa - trajes populares rurais)|Das 10h ate as 13h e das 15h ate as 18h.
Castelo de Santiago da Barra|Situada junto ao mar, pensa-se que a primeira fortificacao colocada na barra da Foz do rio Lima datara do reinado de D. Afonso III.|Das 10h ate as 13h e das 15h ate as 18h. (19h no Verao)
Citania de Santa Luzia|Conhecida localmente por "Cidade Velha", e um dos Castros mais conhecidos do Norte de Portugal.|Das 10h ate as 13h e das 14h ate as 18h.
Santuario de Santa Luzia|Comecou a ser construida em 1903 e terminou 40 anos depois. Foi considerada como inspirada na Basilica de Sacre Coeur, em Paris.|Das 8h ate as 17h. (19h no Verao)
Igreja Matriz|Considerada como Igreja Matriz, esta situada no centro historico desta cidade, na Praca da Republica. As suas obras iniciaram em 1400 ate 1433.|Das 8h20 ate as 12h e das 15h ate as 19h.
Viana do Castelo
Termas romanas de Maximinos|Escavacoes arqueologicas no local puseram a descoberto as ruinas de termas publicas junto ao "Forum" da antiga cidade romana de "Bracara Augusta".|Das 9h ate as 12h30 e das 14h ate as 17h30.
Museu Arqueologico D.Diogo de Sousa|As suas colecoes sao fundamentalmente constituidas por espolio resultante da investigacao arqueologica realizada na regiao Norte.|Das 9h ate as 17h30. (18h no Verao)
Fonte do Idolo|Construida pelo povo romano, a Fonte do Idolo e um santuario dedicado a um deus local chamado Tongoenabiago, associado aos cursos de agua.|Das 9h ate as 12h30 e das 14h ate as 17h30.
Se de Braga|A Se e datada do ano de 400. No subsolo da capela-mor encontram-se os vestigios arqueologicos do templo primitivo paleocristao e altomedieval.|Das 9h30 ate as 12h30 e das 14h30 as 17h30. (18h30 no Verao)
Braga
Serra do Marao|Abrange um extenso territorio e de paisagens diversificadas situado entre as fronteiras com a regiao do Minho, do Douro e de Tras-os-Montes.|Sem Horario Aparente
Pinhao|Bonita vila da regiao Norte do Pais situada na margem direita do rio Douro, sendo considerada o coracao do Alto Douro Vinhateiro.|Sem Horario Aparente
Parque Natural do Alvao|E uma area protegida de Portugal de reduzidas dimensoes e situada entre os concelhos de Mondim de Basto e Vila Real|Sem 0
Peso da Regua|E uma vila do Norte do pais conhecida por ser a capital da regiao demarcada que produz o celebre Vinho do Porto.|Sem Horario Aparente
Fisgas de Ermelo|E uma cascata portuguesa com uma das maiores quedas de agua de Portugal e uma das maiores da Europa. Nao se precipita numa vertical absoluta.|Sem Horario Aparente
Vila Real
Rio de Onor|Divide o territorio com a aldeia espanhola, Rihonor de Castilla. Da tradicao e do convivio entre as duas aldeias surgiu um dialecto (o rionores).|Sem Horario
Domus Municipalis|Um dos objectivos desta construcao consistia na valorizacao de uma nascente e a recolha das aguas pluviais.|Das 10h ate as 17h. (Fecha as 18h nos Sabados e Domingos)
Castelo de Braganca|Foi por volta de 1409 que o rei D. Joao I mandou construir o Castelo de Braganca numa vigorosa afirmacao de independencia perante Leao e Castela.|Das 9h ate as 12h e das 14h ate as 17h.
Cidadela de Braganca|Uma cidade dentro de outra com quase 900 anos de diferenca. O pequeno perimetro da Cidadela Brigantina serviu para a defesa da antiga vila medieval.|Sem Horario Aparente
Braganca
Livraria Lello|Considerada como uma das mais belas livrarias do mundo. No seu interior, encontra um ambiente unico onde se destaca uma impressionante escadaria.|Das 9h30 ate as 17h.
Igreja do Carmo|Este edificio parece ser um so, mas esta Igreja e a Igreja dos Carmelitas estao separadas pelo edificio mais estreito do Porto, a Casa Escondida.|Das 9h ate as 18h.
Torre dos Clerigos|No cimo da Torre dos Clerigos, podera defrutar de uma das mais belas vistas sobre a cidade do Porto.|Das 9h ate as 19h.
Muralha Fernandina|Construida no sec. XIV, esta muralha protegia a cidade do Porto que se tinha expandido para alem da cerca velha.|Dias uteis das 9h ate as 17h.
Porto
Ria de Aveiro|E uma autentica rede de canais e ilhas que vale a cidade de Aveiro a alcunha de "Veneza portuguesa".|Sem Horario Aparente
Museu de Aveiro|O Museu de Aveiro esta instalado no antigo Convento de Jesus da Ordem Dominicana feminina, um dos mais antigos de Aveiro.|Das 10h ate as 12h30 e das 13h30 ate as 18h.
Costa Nova|Estas construcoes implantadas a beira da praia, utilizadas originalmente pelos pescadores da zona para guardar os materiais de pesca.|Sem Horario Aparente
Reserva Natural das Dunas de Sao Jacinto|A vegetacao e muito caracteristica e, no sec. XIX, foram plantadas Acacias e Pinheiros bravos, num esforco para fixar as dunas.|Sem Horario Aparente
Aveiro
Porta do Soar|E uma das duas portas que restam da muralha medieval, tendo sido mandada erigir por D. Joao I e concluida no reinado de D. Afonso V.|Disponivel 24h por dia.
Porta dos Cavaleiros|Da zona da Se, passando pela Porta dos Cavaleiros, vemos uma das duas portas que restam da muralha medieval, do sec. XV.|Disponivel 24h por dia.
Casa da Ribeira|Esta casa tradicional de lavoura exibe artesanato da regiao e muita informacao sobre o saber regional de artes que estao em risco de desaparecimento.|Das 10h ate as 13h e das 14h ate as 18h.
Museu do Quartzo|E dedicado ao quartzo, explicando a origem daquele minerai, dos mais abundantes da crosta terrestre, as suas propriedades fisicas e quimicas.|Das 10h ate as 18h.
Museu Nacional Grao Vasco|O mais rico e importante de Viseu, esta localizado no antigo Palacio dos Bispos, ao lado da catedral.|Das 10h ate as 13h e das 14h ate as 18h.
Viseu
Castelo Mendo|Aldeia rodeada por muralhas, com 6 portas medievais e casas de pedra. As estradas estreitas, facilitavam a defesa da aldeia durante as guerras.|Sem Horario Aparente
Castelo Rodrigo|Esta aldeia historica e um autentico espaco monumental que conserva importantes referencias no plano medieval.|Sem Horario Aparente
Sabugal|Localizada numa area montanhosa foi palco de diversos conflitos e batalhas, envolvida por diversas fortificacoes defensivas.|Sem Horario Aparente
Sortelha|Esta encantadora aldeia e a mais antiga da linha de fortalezas que protegiam a fronteira Este da Guarda e Covilha.|Sem Horario Aparente
Trancoso|Foi terra de fronteira, palco de diversas lutas e batalhas marcantes para a formacao e independencia do reino.|Sem Horario Aparente
Almeida|Classificada como aldeia historica, foi construida em redor de um castelo medieval, num local importante como ponto de defesa estrategico da regiao.|Sem Horario Aparente
Linhares da Beira|Situada na Serra da Estrela, conta com paisagens montanhosas, de ar puro, e aguas frescas e puras, cultura, artes medievais e renascentistas.|Sem Horario Aparente
Guarda
Universidade de Coimbra|Situada no ponto mais elevado da cidade, e uma das universidades mais antigas do mundo e a mais antiga de Portugal.|Das 9h ate as 19h.
Se Velha|E a unica catedral portuguesa construida na epoca da Reconquista, cuja estrutura esta praticamente intacta.|Das 10h ate as 18h.
Conimbriga|E um dos maiores complexos de ruinas romanas de Portugal e um local excelente para ter uma visao dos tempos passados.|Das 10h ate as 19h.
Igreja de Santa Cruz|Uma das igrejas mais antigas de Portugal. Com um belo painel de azulejos, um imponente orgao e um altar cheio de magnificos detalhes.|Das 9h ate as 17h.
Mosteiro de Santa Clara-a-Velha|A Rainha Santa Isabel interessou-se pelo convento, ja extinto, e mandou construir novos edificios em estilo gotico.|Das 10h ate as 19h.
Coimbra
Castelo e Muralhas de Castelo Branco|Esta fortificacao integrava um sistema defensivo mais amplo, erigido ao longo do vale do Rio Tejo.|Sem Horario Aparente
Portados quinhentistas|O estudo das casas que ostentam estes Portados Quinhentistas revela tratar-se de uma arquitectura de parcos recursos.|Sem Horario Aparente
Ermida de Nossa Senhora de Mercoles|O portal da entrada e dois portais laterais sao ogivais. No interior existem azulejos, possivelmente hispano-arabes, e vestigios de frescos.|Das 9h ate as 18h.
Centro de Interpretacao do Bordado|Equipamento projectado para promover a revalorizacao, recuperacao, inovacao e relancamento do ex-libris da cidade, classificado como peca artesanal.|Das 9h ate as 19h.
Castelo Branco
Castelo de Leiria|Numa localizacao estrategica onde o 1o Rei de Portugal, edificou este castelo para defender a fronteira sul do reino.|Das 10h ate as 18h. (Das 9h30 ate as 17h30 no Inverbo)
Santuario de Nossa Senhora da Encarnacao|Trata-se de uma igreja de peregrinacao que foi edificada no seculo XVI sobre a antiga Ermida de Sao Gabriel.|Das 9h ate as 14h. (Das 9h ate as 18h nos Fins-de-Semana)
Monte Real|Conhecida pelas suas termas, combina natureza e patrimonio. La encontram-se as ruinas dos paços reais e um pelourinho datado de 1573.|Sem Horario
Centro Historico|O desafio e deambular pelo casco velho de Leiria, um espaco rico em elementos arquitectonicos, que tem vindo nos ultimos anos a rejuvenescer.|Sem Horario
Leiria
Jardim das Portas do Sol|Para alem de uma vista fantastica sobre o rio Tejo, neste local pode visitar o Nucleo Museolocico e Centro de Interpretacao Urbi Scallabis.|Das 8h ate as 19h.
Igreja de Santa Maria da Graca|Em estilo gotico flamejante, foi construida em Santarem no ano de 1380, a pedido de D. Afonso Telo de Meneses, primeiro Conde de Ourem.|Das 10h ate as 18h.
Gruta do Algar da Pena|Do cimo de perto de 40 m de desnivel, abre-se uma paisagem subterranea pouco vulgar, atraves de uma enorme profusao de espeleotemas.|Apenas com marcacao previa.
Santarem
Castelo de Portalegre|Castelo medieval cuja construcao ocorreu ja no reinado de D. Dinis, por volta de 1290.|Das 10h ate as 17h.
Museu da Tapecaria de Portalegre|E um espaco dedicado a apresentacao, conservacao e estudo das Tapecarias de Portalegre.|Das 9h30 ate as 13h e da 14h30 ate as 18h.
Castelo de Vide|E uma vila portuguesa no Distrito de Portalegre, regiao do Alentejo e sub-regiao do Alto Alentejo com cerca de 2300 habitantes.|Sem Horario
Marvao|Entre a vila de Castelo de Vide e a cidade de Portalegre, Marvao domina a paisagem serrana a partir no seu ponto mais alto.|Sem Horario
Portalegre
Mosteiro dos Jeronimos|O Mosteiro e do estilo manuelino, a sua construcao comecou em 1501 e durou cerca de 100 anos.|Abre as 8h30 e fecha as 19h.
Torre de Belem|E uma mistura de uma torre medieval e um baluarte defensivo.|Abre as 9h e fecha as 18h30.
Museu dos Coches|Nao perca a maior colecao do mundo de carruagens e veiculos reais.|Abre as 8h e fecha as 20h.
Lisboa
Museu de Arqueologia e Etnografia de Setubal|Dedicada a etnografia regional: tradicoes regionais, piscatoria, agricola, criacao de gado, construcao naval, tecelagem e artesanato popular.|Das 9h ate as 12h30 e das 14h ate as 17h30.
Portinho da Arrabida|Apesar de nao ter uma grande extensao possui aguas totalmente cristalinas e um bonito areal dourado.|Sem Horario
Moinho de Mare da Mourisca|Originalmente constituido por uma sala de moagem, uma outra de armazenamento e uma casa de apoio ao moleiro.|Das 9h ate as 19h30.
Setubal
Templo Romano de Evora|Construido no seculo I d.C. para servir de local de culto ao imperador Augusto e ainda conserva 14 das suas colunas.|Aberto 24h por dia.
Se Catedral de Evora|Considerada como a maior catedral medieval portuguesa, do estilo gotico de transicao, contendo alguns elementos romanos.|Das 9h ate as 17h.
Aqueduto de Agua de Prata|E um dos maiores aquedutos de Portugal. Trazia agua das nascentes de Graca do Divor ate ao centro da cidade.|Aberto 24h por dia.
Cromeleque dos Almendres|Este monumento megalitico inicialmente era constituido por mais de uma centena de monolitos.|Aberto 24h por dia.
Evora
Castelo de Beja|E um Castelo medieval, que foi construido em finais do sec. XIII sobre umas fundacoes romanas, por ordens do rei D. Dinis.|Das 9h30 ate ao 12h30 e das 14h ate as 18h.
Nucleo Museologico do Sembrano|Integra um conjunto de estruturas arqueologicas com vestigios desde a Pre-Historia ate a Epoca Contemporanea.|Das 9h30 ate as 12h30 e das 14h ate as 18h.
Ruinas Romanas de Pisoes|Escavacoes arqueologicas e estudos efectuados nas Ruinas, confirmam que a villa tera sido ocupada entre os seculos I e IV d.C.|Das 9h ate as 17h.
Beja
Palacio de Estoi|A construcao do Palacio de Estoi foi levada a cabo pelo arquitecto Domingos da Silva Meira, que cultivava um grande gosto pela escultura.|Das 9h ate as 19h.
Capela dos Ossos de Faro|A capela e forrada com os ossos de mais de mil esqueletos e esses ossos decoram as paredes e os tectos em macabros padroes geometricos.|Das 10h ate as 13h e das 15h ate as 18h.
Ruinas Romanas de Milreu|Opulenta villa do Imperio Romano que continuou ocupada durante a Antiguidade tardia e os primeiros tempos de dominio do Islao.|Das 10h30 ate as 13h e das 14h ate as 18h30.
Parque Natural da Ria Formosa|E um labirinto de canais, ilhas, sapais e bancos de areia, que atrai uma fauna variada que inclui numerosas especies de aves.|Das 8h ate as 19h. (ate as 20h no Verao)
Faro
Pico Ruivo|Com os seus 1862 metros, e o ponto mais alto da ilha da Madeira e o terceiro Pico de Portugal.|Sem Horario
Funchal|E conhecido pelo seu artesanato, pelo vinho e pelo clima agradavel.|Sem Horario
Camara de Lobos|Para alem dos barcos coloridos de pesca, vai encontrar, ao lado da vila, uma das falesias mais altas da Europa, o Cabo Girao.|Sem Horario
Porto Moniz|E uma pequena vila localizada no noroeste da ilha, famosa pelas suas piscinas vulcanicas naturais.|Sem Horario
Curral das Freiras|E uma pequena aldeia no fundo de varias montanhas com a particularidade de ter estado isolada ate 1959.|Sem Horario
Madeira
Lagoa das Sete Cidades|Maior reservatorio natural de agua doce de superficie dos Acores, caracterizada pela dupla coloracao das suas aguas.|Sem Horario
Ilheu de Vila Franca|E o resultado da cratera de um antigo vulcao submerso, tendo as paredes da sua cratera revestidas por uma vegetacao endemica.|Sem Horario
Lagoa do Fogo|Vale a pena conhecer as belezas paisagisticas e naturais desta maravilha natural e da sua caldeira.|Sem Horario
Aldeia da Cuada|E uma aldeia por onde nunca circulou um veiculo motorizado e que se mantem fiel ao traco da arquitectura rural da ilha.|Sem Horario
Lagoa de Santiago|Ocupa uma cratera vulcanica, bem visivel no proximo Miradouro da Lagoa do Canario, de onde se tem um panorama de beleza impar.|Sem Horario
Lagoa das Empadadas|Sao um conjunto de pequenas lagoas rodeadas por um lindissimo bosque e separadas entre si por pequenas faixas de terras.|Sem Horario
Acores
